R 999 999

C 255,255,255
F 8,9,10

NO      ./murmoussu.xpm
SO ./murmoussu2.xpm
WE ./murmoussu3.xpm
EA ./murmoussu4.xpm
S   ./OKSp.xpm

 11111111111111111
1S0000000000000001
100001000000000001
10001220000111111
100000000001111001
100000000000000001
100000000000000001
111111111111111111
