R 999 999

C 40,60,30
F 60,30,30

NO      ./murmoussu.xpm
SO ./murmoussu2.xpm
WE ./murmoussu3.xpm
EA ./murmoussu4.xpm
S   ./OKSp.xpm

 11111111111111111
100000000000000001
100001000000000001
100012200001111111
100000000001111001
100000N00000000001
100000000000000001
111111111111111111
