R 1000 1000
C 33,43,19
F 120,145,100

NO      ./murmoussu.xpm
SO ./murmoussu2.xpm
WE ./murmoussu3.xpm
EA ./murmoussu4.xpm
S   ./OKSp.xpm

111111111111111111
1S0000000000000001
100000000000000001
100000000001111101
100000000001111001
100000000000000001
120000000000000001
111111111111111111
