R 900 900
C 33,43,19
F 120,145,100

NO      ./murmoussu.xpm
SO ./murmoussu2.xpm
WE ./murmoussu3.xpm
EA ./murmoussu4.xpm
S   ./OKSp.xpm

111111111
100000001
100000001
1E0000021
100000001
100000001
111111111
