R 1500 1000
C 33,43,19
F 120,145,100

NO      ./murmoussu.xpm
SO ./murmoussu2.xpm
WE ./murmoussu3.xpm
EA ./murmoussu4.xpm
S   ./OKSp.xpm

111111111
100000001
100000221
1E0200221
100000221
111111111
