R 1500 1000
C 350, 255, 255
F 60,30,30

NO      ./textures/murmoussu.xpm
SO ./textures/murmoussu2.xpm
WE ./textures/murmoussu3.xpm
EA ./textures/murmoussu4.xpm
S   ./textures/OKSp.xpm


111111111111111111
111111111111111111
100000000000000001
100001000000000001
10001220W001111111
100000000001111001
100000000000000001
100000000000000001
100000000000000001
100000000000000001
111111111111111111
